NO ./textures/amethyst_160x160.xpm
SO ./textures/end_stone_160x160.xpm
EA ./textures/grass_block_160x160.xpm
WE ./textures/warped_nylium_160x160.xpm
F                       255,0,50
C 23,51,12


11111
00N01
11111
