NO ./textures/wall_north.xpm
SO ./textures/wall_south.xpm
WE ./textures/wall_west.xpm
EA ./textures/wall_east.xpm
F 100,100,100
C 200,200,255

11111111111
11100000001
11100000001
11000000001
10000000001
10000001111
100E0000001
10000001111
11111111111
