NO ./textures/wall_north.xpm
SO ./textures/wall_south.xpm
WE ./textures/wall_west.xpm
EA ./textures/wall_east.xpm
F 100,100,100
C 200,200,255

1111111111111111111111111111111111111111
1000100000111010000000101000000000000001
1000100000111010000000101000000000000001
1000100000111010000000101000000000000001
1000100000100000000000000000000000000001
1000S00000000000000000000000000000000001
1000000000110000000000001000000000000001
1010000000000010000000101000000000000001
1010000000111010000000101000000000000001
1111111111111111111111111111111111111111
