NO ./textures/wall_north.xpm
SO ./textures/wall_south.xpm
WE ./textures/wall_west.xpm
EA ./textures/wall_east.xpm
F 100,100,100
C 200,200,255

            1111111111111111111111111111111111111111                     
            1010000000111010000000101000000000000001                  
            1010000000111010000000101000000000000001             
            1010000000111010000000101000000000000001
            1010000000111010000000101001111111111111
  1111111111111010000000101000000000000001
  1010000000111010000000101000000000000001                                                                  
  1010000000111010000000101000000000000001
  10000000001S1000000000000000000000000001
  1000000000001000000000000000000000000001
  1000000011111010000000001000000000000001
  1010000000000010000000101000000000000001
  1010000000111010000000101000000000000001
  1111111111111111111111111111111111111111
