NO ./textures/wall_north.xpm
SO ./textures/wall_south.xpm
WE ./textures/wall_west.xpm
EA ./textures/wall_east.xpm
F 100,100,100
C 200,200,255

            1111111
            1S10001
            1000001
            1110001
             1111111
